1111111111111111
100100000P100001
100111001E100001
1001C00010100011
1111111111111111