111111111111111111111
1C0000CCCC000000110C1
1000101000000001C0011
1P001E100000000CCCCC1
111111111111111111111