111111111111111111111111111111111111111111111111111111111111
1C0000CCCC000000000C000000C111111100000000CCC0000C0000000C11
1000101000000001C001100001000000000000100000000001C110000111
100010100100000110111C00010000000111000100100000011111000001
1P001E100000000CCC11000C000011C11CCCC11CCCCC1110000000000001
1C0000CCCC010001110C000000011111110000000000C0110C0001000C11
1000101000000001C0011000010000000000001C00000001101110000111
1C0000C1CC010100000C0000100110C11100000000CC10000C0000000011
1000101000010011C00110000100000000000010000011000110100C0001
1C00C00CCC0000C1000C00C0000111101100000000C0C0000C0000000011
1000101000110001C00110000100001C100000100C00011100111001C111
111111111111111111111111111111111111111111111111111111111111